@@@@@@@@@   @@@@@@@@
@                  @
@                  @
@                  @
@                  @
@        @@        @
@        @@        @
                   
                   
             @     
@                  @
@    @@            @
@    @@            @
@                  @
@            @@    @
@            @@    @
@                  @
@                  @
@                  @
@@@@@@@@@   @@@@@@@@