1,8,1,3
5
@@@@@@@@####@@@@@@@@
@                  @
@                  @
@                  @
@                  @
@                  @
@                  @
#                  #   
#                  #
#                  #
#                  #
@                  @
@                  @
@                  @
@                  @
@                  @
@                  @
@                  @
@                  @
@@@@@@@@####@@@@@@@@